111111111111111
1P00000000000C1
100001111100001
11110CE11111111
10000M000000111
1C00000011100C1
111111111111111