1111111111111
10010000000M1
1000011111001
1C0P11E000001
1111111111111