111111111111111111111111
1P0000000010000000011111
100011000001111000C11111
100011000000000000C11111
100011111100000000011111
100000000000000000011111
100000000000000000011111
100000000011111100011111
100000000000000100011111
100000000000000100011111
111110000000000100011111
1C0000000011111000011111
100000000000000000011111
100000000000000000011111
100000000011111111011111
100000C00000000M00011111
100011111000000000011111
1C0010000000010E00011111
100000000000000000011111
111111111111111111111111