11111111111111111111111111111111111
1P000000000000000000000111111111001
10111111111111111100000100000001001
10100000C0000000010000010000C001001
10111111111111100010C00100000001001
10000000000000000M11111100000001001
100000C000000010000000000E000000001
11111111111111111111111111111111111