111111111111111
1P00000000000C1
100001111100001
1C0011E000000C1
100000000000001
1000110M0000001
10C0000111000C1
111111111111111